{
  "name": "Baum",
  "map": [
    [0,0,0,0,0,0,0,0,0,0,0],
    [0,0,0,0,0,0,0,0,0,0,0],
    [0,0,0,0,0,0,0,0,0,0,0],
    [0,0,1,1,1,1,1,1,1,1,0],
    [0,0,1,1,1,1,1,1,1,1,0],
    [0,0,1,1,1,1,1,1,1,0,0],
    [0,1,1,1,1,1,1,1,1,0,0],
    [0,1,1,1,1,1,1,1,1,0,0],
    [0,0,1,1,1,1,1,1,1,1,0],
    [0,0,0,1,1,1,1,1,1,0,0],
    [0,0,0,0,0,1,0,0,0,0,0],
    [0,0,0,0,0,1,0,0,0,0,0]
  ],
  "interactables": [
    {
      "type": "Person",
      "name": "depp",
      "positionX": 5,
      "positionY": 3
    },
    {
      "type": "Door",
      "positionX": 5,
      "positionY": 11,
      "target": "wald",
      "targetSpawnX": 9,
      "targetSpawnY": 28
    }
  ]
}