{
  "name": "Baum",
  "map": [
    [0,0,0,0,0,0,0,0,0,0,0],
    [0,0,0,0,0,0,0,0,0,0,0],
    [0,0,0,0,0,0,0,0,0,0,0],
    [0,0,1,1,1,"Depp",1,1,1,1,0],
    [0,0,1,1,1,1,1,1,1,1,0],
    [0,0,1,1,1,1,1,1,1,0,0],
    [0,1,1,1,1,1,1,1,1,0,0],
    [0,1,1,1,1,1,1,1,1,0,0],
    [0,0,1,1,1,1,1,1,1,1,0],
    [0,0,0,1,1,1,1,1,1,0,0],
    [0,0,0,0,0,1,0,0,0,0,0],
    [0,0,0,0,0,0,0,0,0,0,0]
  ],
  "interactables": {
    "Depp": {
      "type": "Person"
    },
    "Wald": {
      "type": "Door",
      "targetSpawnX": 1,
      "targetSpawnY": 1
    }
  }
}